12 12
*#..........
.#.....#.#..
.#.#...#.#..
.......#.#..
##.#...#.#..
...#..#..#..
...#.#...#..
####.#...#..
.....#.###..
.....#...#..
.....#####..
.........#.o